NO ./texture/backroom.xpm
WE ./texture/backroom.xpm

EA												 ./texture/backroom.xpm
SO ./texture/backroom.xpm

F     249,246,173

Door ./texture/porte.xpm

C 249,246,173

1111111111111111111111111111111111111111
100000000000011100D000000000000000000001
1011111011111011111001111111111111111111
1010000010000010001000000000000000000001
101101101101111101101111111111D111111111
10100000100000000D0000000000000000000001
101D11101111111101111111111D111111111111
1000000010000000010000000000000000000001
1111011011011111011011111111111111111111
1000000010000000000000000000000000000001
111D111011111011111001111111111111111111
1000000010000010001000000000000000000001
1111011011111011011011111111111111111111
1000000000000000000000000000000000000001
11111D1111111111111D11111111111111111111
1000000010000010001000000000000000000001
1011111011111011111011111111111D11111111
1000000010000000010000000000000000000001
1011111011111011111011111111111111111D11
1000000000000000000N00000000000000000001
1111111111111111111111111111111111111111



